p&&&&&&&&&
&&&&&&&&&&
&&&&&&&&&&
&&&&&&&&&&
&&&&&&&&&&
&&&&&&&&&&
&&&&&&&&&&
&&&&&_&&&P
_E&&&&&&&_
__________